%%%%%%%%%%%%%%
%           P%
%            %
%            %
%            %
%            %
%            %
%G        G  %
%%%%%%%%%%%%%%
% % %%%%%%%%%%
%%%%%%%%%%%%%%
