%%%%%%%%%%%%%%
%           P%
%%%%         %
%G           %
%%%%        G%
%..       %%%%
%%%%%%       %
%G           %
%%%%%%%%%%%%%%
% % % %%%%%%%%
%%%%%%%%%%%%%%