%%%%%%%%%%%%%%
%           G%
%       %%%%%%
%%%%       ..%
%G        %%%%
%           G%
%         %%%%
%P           %
%%%%%%%%%%%%%%
% % % %%%%%%%%
%%%%%%%%%%%%%%