%%%%%%%%%%%%%%
%G           %
%%%%%%    % G%
%..       %%%%
%%%%  .   % G%
%..%         %
%  %       %%%
%P         ..%
%%%%%%%%%%%%%%
% % % %%%%%%%%
%%%%%%%%%%%%%%