%%%%%%%%%%%%%%
%  G        G%
%            %
%            %
%            %
%            %
%            %
%P           %
%%%%%%%%%%%%%%
% % %%%%%%%%%%
%%%%%%%%%%%%%%
