%%%%%%%%%%%%%%
%P           %
%            %
%            %
%            %
%            %
%            %
%  G        G%
%%%%%%%%%%%%%%
% % %%%%%%%%%%
%%%%%%%%%%%%%%