%%%%%%%%%%%%%%
%P         ..%
%  %       %%%
%..%         %
%%%%   .  % G%
%..       %%%%
%%%%%%    % G%
%G           %
%%%%%%%%%%%%%%
% % % %%%%%%%%
%%%%%%%%%%%%%%