%%%%%%%%%%%%%%
%P           %
%            %
%       G    %
%           G%
%            %
%     %%%%%%%%
%           G%
%%%%%%%%%%%%%%
% % % %%%%%%%%
%%%%%%%%%%%%%%
