%%%%%%%%%%%%%%
%           G%
%     %%%%%%%%
%            %
%           G%
%       G    %
%            %
%P           %
%%%%%%%%%%%%%%
% % % %%%%%%%%
%%%%%%%%%%%%%%