%%%%%%%%%%%%%%
%P           %
%         %%%%
%           G%
%G        %%%%
%%%%       ..%
%       %%%%%%
%           G%
%%%%%%%%%%%%%%
% % % %%%%%%%%
%%%%%%%%%%%%%%