%%%%%%%%%%%%%%
%..         P%
%%%       %  %
%         %..%
%G %   .  %%%%
%%%%       ..%
%G %    %%%%%%
%           G%
%%%%%%%%%%%%%%
% % % %%%%%%%%
%%%%%%%%%%%%%%