%%%%%%%%%%%%%%
%            %
% %%%%%%%%%  %
% %      G%  %
% % %%%%%%%  %
% %          %
% %%%%%%%%%%%%
%           P%
%%%%%%%%%%%%%%
% %%%%%%%%%%%%
%%%%%%%%%%%%%%
